111111111111111111111111111111111111111111111111111111111111
111111111111111111111111111111111111111111111111111111111111
111111111111111111111111111111111111111111111111111111111111
111111111111111111111111111111111100000011111111111111111111
111111111111111111111111111111110000000001111111111111111111
111111111111111111111111111110000000000001111111111111111111
111111111111111111111111111000000000000000111111111111111111
111111111111111111111111100000000011110000111111111111111111
111111111111111111111111000000001111110000011111111111111111
111111111111111111111110000001111111111000011111111111111111
111111111111111111111100000111111111111000011111111111111111
111111111111111111111000001111111111111100011111111111111111
111111111111111111111000011111111111111100001111111111111111
111111111111111111111000011111111111111100001111111111111111
111111111111111111110000111111111111111110001111111111111111
111111111111111111100000111111111111111110001111111111111111
111111111111111111100001111111111111111100001111111111111111
111111111111111111100001111111111111111100001111111111111111
111111111111111111000011111111111111111100001111111111111111
111111111111111111000011111111111111111100011111111111111111
111111111111111111000111111111111111111100011111111111111111
111111111111111111000111111111111111111100011111111111111111
111111111111111110000111111111111111111100011111111111111111
111111111111111110000111111111111111111000011111111111111111
111111111111111110001111111111111111111000011111111111111111
111111111111111110001111111111111111111000111111111111111111
111111111111111110001111111111111111111000111111111111111111
111111111111111110001111111111111111111000111111111111111111
111111111111111110001111111111111111110000111111111111111111
111111111111111110000111111111111111100000111111111111111111
111111111111111110000111111111111111100000111111111111111111
111111111111111111000111111111111111000001111111111111111111
111111111111111111000111111111111111000011111111111111111111
111111111111111111000111111111111111000011111111111111111111
111111111111111111000011111111111110000111111111111111111111
111111111111111111000011111111111110000111100000000000111111
111111111111111111220011111111111100000100000000000000001111
111111111111111111111221111111111100000000000000000000001111
111111111111000000011111111111111000000000000011111000000111
111111111111000000000000011111100000000000011111111110000111
111111111110000000000003011111000000000001111111111111000111
111111111100000111100000011111000000000111111111111111000111
111111111100000111111111111111000000001111111111111111000111
111111111000001111111111111111100000111111111111111111000111
111111111000011111111111111111111111111111111111111110000111
111111111000011111111111111111111111111111111111111110000111
111111110000111111111111110000001111111111111111111000000111
111111110000111111111111100000001111111111111111100000001111
111111110001111111111100000000000111111111111100000000001111
111111110001111111100000000000000011111111110000000001111111
111111110000111000000000000110000000111111000000000011111111
111111110000000000000000011111000000000000000000011111111111
111111110000000000000111111111100000000000000001111111111111
111111111000000001111111111111111000000000000111111111111111
111111111111111111111111111111111111000011111111111111111111
111111111111111111111111111111111111111111111111111111111111
111111111111111111111111111111111111111111111111111111111111
111111111111111111111111111111111111111111111111111111111111
111111111111111111111111111111111111111111111111111111111111
111111111111111111111111111111111111111111111111111111111111
